source	human_translation	opus_mt_translation
A Beautiful Mind	Игры разума	Прекрасный ум
Game theory can be explained broadly as a study of behaviour of rational beings in cooperative and non-cooperative decision making.	Теорию игр можно в широком смысле объяснить как учение о поведении рациональный существ в кооперативном и некооперативном принятии решений.	Теория игр может быть широко объяснена как исследование поведения рациональных существ в процессе принятия решений на основе сотрудничества и без сотрудничества.
It’s a relatively new field of science that emerged in the second half of the 20th century.	Это достаточно новая отрасль науки, появившаяся во второй половине XX века.	Это относительно новая область науки, которая появилась во второй половине XX века.
Globalization of economics, advent of nuclear weaponry and emergence1 of computers were all major milestones in the history of humanity, and each subsequently dictated the need to formalize at least the most common trade and war strategies.	Глобализация экономики, возникновение ядерного оружия и компьютеров стали значительными вехами в истории человечества, и каждая из них впоследствии диктовала необходимость формализовать по крайней мере самые распространённые торговые и военные стратегии.	Глобализация экономики, появление ядерного оружия и появление компьютеров - все это важные вехи в истории человечества, и каждый из них впоследствии диктовал необходимость формализации по крайней мере наиболее общих стратегий в области торговли и войны.
A game is usually defined as a process involving two or more actors, each of them having something to gain or lose through their actions after the game is finished (or ‘solved’).	Игру обычно определяют как некий процесс, в который вовлечено два или более актора, при этом у каждого из них есть возможность что-то получить или потерять в силу своих действий после того, как игра заканчивается (или «решена»).	Игра обычно определяется как процесс с участием двух или более актеров, каждый из которых имеет возможность получить или проиграть через свои действия после завершения игры (или &quot; решённый &quot; ).
Thus, the definition applies to most of the regular games (like, for example, poker), but can be broadened as necessary to cover multitudes of other situations, both real and hypothetical.	Таким образом это определение подходит большинству обычных игр (например, покеру), но также может быть расширено и на множество других ситуаций, как реальных, так и гипотетических.	Таким образом, это определение применяется к большинству обычных игр (например, покер), но при необходимости может быть расширено, с тем чтобы охватить множество других ситуаций, как реальных, так и гипотетических.
The action is presumed to be taken by a ‘rational agent’ - that is, an actor that acts consistently and always chooses an action that is the most optimal in terms of loss/gain ratio according to his current position.	Предполагается, что действие производится «рациональным агентом» – актором, который действует последовательно и всегда выбирает действие, наиболее оптимальное в контексте убытков/прибылей в текущей ситуации.	Предполагают, что это действие было предпринято &quot; реляционным агентом &quot;, т.е. тем субъектом, который действует последовательно и всегда выбирает действия, которые являются наиболее оптимальными с точки зрения соотношения убытков и прибылей в соответствии с его нынешним положением.
A game can be cooperative or non-cooperative, allowing or disallowing willing alliances between the participants respectively.	Игра может быть кооперативной или некооперативной, соответственно, позволяя или не позволяя участникам создавать альянсы друг с другом по собственной воле.	Игра может осуществляться на основе сотрудничества или отказа от сотрудничества, что позволяет или исключает создание добровольных альянсов между участниками, соответственно.
The study of cooperative games usually focuses on why and how the coalitions form, and what actions the members of any coalition would take at any given time.	Изучение кооперативных игр обычно фокусируется на том, почему и как возникают коалиции, и какие действия члены коалиций могут принимать в то или иное время.	Изучение кооперативных игр обычно сосредоточено на том, почему и как формируются коалиции и какие действия будут предпринимать члены любой коалиции в любой данный момент времени.
The study of non-cooperative games instead focuses on individual players and on finding a solution called Nash equilibrium.	Изучение некооперативных игр, в свою очередь, фокусируется на отдельных игроках и нахождении решения, которое называется равновесием Нэша.	Вместо этого в исследовании некооперационных игр основное внимание уделяется отдельным игрокам и поиску решения под названием баланс Нэша.
Nash equilibrium is a state of a game in which no player, knowing the strategies of other players, can change his own strategy to better his own odds while the other strategies are unchanged.	Равновесием Нэша называется такое состояние игры, при котором ни один игрок, зная стратегии других игроков, не может изменить свою собственную стратегию так, чтобы получить какую-либо выгоду, пока другие стратегии остаются неизменными.	Баланс Нэша — это состояние игры, в которой ни один игрок, знающий стратегии других игроков, не может изменить свою собственную стратегию, чтобы улучшить свои собственные шансы, в то время как другие стратегии остаются неизменными.
Essentially, this means that all of the players have found the best possible (or ‘optimal’) outcome of the game for themselves, given the current rules and circumstances.	По сути это значит, что все игроки нашли наилучшее из возможных («оптимальное») решение игры для себя с учётом текущих правил и обстоятельств.	По сути, это означает, что все игроки нашли для себя наилучший результат (или &quot; оптимальный &quot; ) игры, учитывая нынешние правила и обстоятельства.
Mathematician John Forbes Nash, who was an author of the concept, proved that this equilibrium is possible to find for any finite game.	Математик Джон Форбс Нэш, автор этой идеи, доказал, что такое равновесие возможно найти для каждой конечной игры.	Математик Джон Форбс Нэш, который был автором этой концепции, доказал, что это равновесие можно найти для любой конечной игры.
One of the most famous examples of finding Nash equilibrium is a thought experiment called Prisoner’s dilemma.	Один из наиболее известных примеров нахождения равновесия Нэша – мысленный эксперимент «Дилемма заключённого».	Одним из самых известных примеров нахождения равновесия Нэша является мысленный эксперимент под названием дилемма заключённых.
Suppose there are two prisoners interrogated in two different prison cells.	Допустим, двух заключённых допрашивают в двух разных камерах.	Предположим, что двое заключенных допрашиваются в двух разных тюремных камерах.
They have no way to communicate with each other, but each of them knows that the other is also interrogated.	У них нет возможности как-либо общаться друг с другом, но каждый из них знает, что другого также допрашивают.	У них нет возможности общаться друг с другом, но каждый из них знает, что друг друга тоже допрашивают.
Each prisoner is sentenced to one year in prison.	Каждый заключённый приговорён к одному году тюрьмы.	Каждый заключенный приговаривается к одному году тюремного заключения.
Each prisoner is then offered a deal: if he testifies against the other, he is set free, while the other gets a harsher, 3-year penalty.	Каждому заключённому затем предлагают сделку: если он будет свидетельствовать против другого, он будет отпущен, а наказание другого усиливается до 3 лет в тюрьме.	Затем каждому заключенному предлагается сделка: если он дает показания против другого, то он освобождается, а другой получает более суровое, трехлетнее наказание.
However, if both prisoners testify against each other, both of them will get a harder sentence, and both will serve 2 years in prison.	Однако, если оба заключённых будут свидетельствовать друг против друга, оба получат более тяжелое наказание – по 2 года в тюрьме.	Однако, если оба заключенных будут давать показания друг против друга, они оба получат более суровое наказание, и оба будут отбывать два года тюремного заключения.
Each prisoner can choose either to testify or to remain silent.	Каждый заключённый может выбрать или свидетельствовать, или промолчать.	Каждый заключенный может либо давать показания, либо хранить молчание.
What is the optimal course of action for each prisoner?	Каким будет оптимальный курс действий для каждого заключённого?	Каков оптимальный курс действий для каждого заключенного?
According to game theory, a rational actor would choose to leave prison, condemning the other prisoner.	По теории игр рациональный актор выберет выйти из тюрьмы, обрекая другого преступника на более тяжкое наказание.	Согласно теории игры, рациональный актер решил покинуть тюрьму, осудив другого заключенного.
Thus Nash equilibrium in this situation (and the most optimal outcome) would be reached if both prisoners tried to betray each other and subsequently each served 2 years.	Таким образом равновесие Нэша в данной ситуации (и наиболее оптимальное решение проблемы) будет достигнуто, если оба преступника попытаются предать друг друга и впоследствии каждый отсидит 2 года.	Таким образом, равновесие Нэша в этой ситуации (и наиболее оптимальный результат) было бы достигнуто, если бы оба заключенных пытались предать друг друга и впоследствии отбывали два года.
Knowledge that in any situation with something to gain or lose there is indeed an optimal course of action with maximized profits for any and all participants has very wide implications.	Знание факта, что в каждой ситуации, где возможен какой-то выигрыш или проигрыш, действительно существует оптимальный способ с максимальным выигрышем для всех вовлечённых, имеет очень далеко идущие последствия.	Знания о том, что в любой ситуации, когда есть что-то, что можно получить или потерять, действительно являются оптимальным курсом действий с максимальной прибылью для любого участника, и все участники имеют весьма широкие последствия.
Finding it might be hard, but the willingness to do that, perhaps, can make us able to stop the wars and other major threats to our society.	Найти такое решение может быть сложно, но открытость к возможности сделать это, может быть, даст нам возможность остановить войны и другие глобальные угрозы нашему обществу.	Найти его может быть трудно, но готовность сделать это, возможно, позволит нам остановить войны и другие серьезные угрозы нашему обществу.
For his works in game theory, John Nash was awarded a Nobel Prize in Economic Sciences back in 1994, 45 years after actually writing them down.	За свои работы в теории игр в 1994 году Джон Нэш был награждён Нобелевской премией по экономике, 45 лет спустя после того, как он их записал.	В 1994 году Джон Нэш получил Нобелевскую премию по экономическим наукам за свои работы в теории игр, 45 лет спустя после того, как на самом деле они были записаны.
As of 2020, Nash is the only person ever to be awarded both this prize and the Abel Prize in mathematics, which he was awarded in 2015.	По состоянию на 2020 год Нэш – единственный человек, получивший и эту награду, и Абелевскую премию по математике, которая была присуждена ему в 2015 году.	С 2020 года Нэш является единственным человеком, которому когда-либо была присуждена эта премия и премия Абеля в области математики, которая была присуждена ему в 2015 году.
